9999999999
9022000009
9020000009
9020005009
9000000009
9040000009
9000000009
9000000009
9000060009
9999999999