9999999999999999999999999999999999999999
9000000000000002000000000000000000000009
9000000000000002000000000006000000000009
9000000000000002000000000000000000000009
9000000000000052000000000000000000000009
9000000000000000000040000000000000000009
9000000000000000000000000000000000000009
9000000000000000000000000000000000000009
9000000000000000000000000000000000000009
9000000000000000000000000000000000000009
9000000000000000040000000000000000000009
9000000000000000000000000000000000000009
9000000000000000000000000000000000000009
9000000000000000000000000000000000000009
9000000000000000000000000000000000000009
9000000000000000000000000000000000000009
9000000000000000000000000000000000000009
9000000000000000000000000000000000000009
9000000000000000000000000000000000000009
9000000000000000000000000000000000000009
9000000000000060000000000000000000000009
9000000000000000000000000000000000000009
9000000000003333333322222222222222222229
9000000000000000000300000000000000000009
9000000000000000000300000000000000000009
9000000000000000000300000000000000000009
9000000000000000000300000000000000000009
9000000000000000000300000000000000000009
9000000000000000000300000000000000000009
9999999999999999999999999999999999999999
