40,30
9999999999999999999999999999999999999999
9000000000000002000000000000000000000009
9000000000000002000000000000000000000009
9000000000000002000000000000000000000009
9000000000000002000000000000000000000009
9000000000000000000000000000000000000009
9000000000000000000000000000000000000009
9000000000000000000000000000000000000009
9000000000000000000000000000000000000009
9000000000000000000000000000000000000009
9000000000000000000000000000000000000009
9000000000000000000000000000000000000009
9000000000000000000000000000000000000009
9000000000000000000000000000000000000009
9000000000000000000000000000000000000009
9000000000000000000000000000000000000009
9000000000000000000000000000000000000009
9000000000000000000000000000000000000009
9000000000000000000000000000000000000009
9000000000000000000000000000000000000009
9000000000000000000000000000000000000009
9000000000000000000000000000000000000009
9000000000000000000000000000000000000009
9000000000000000000000000000000000000009
9000000000000000000000000000000000000009
9000000000000000000000000000000000000009
9000000000000000000000000000000000000009
9000000000000000000000000000000000000009
9000000000000000000000000000000000000009
9999999999999999999999999999999999999999
